NO resources/wolftex/badgeOnRedbricks.png
EA resources/wolftex/greybricks.png
SO resources/wolftex/door.png
WE resources/wolftex/figureOnWood.png
DO resources/wolftex/purplestone.png

F 105,105,105
C 0,0,0

     
111111111111
100000010001
100E000D0001
100000010001
111111111111
