NO resources/wolftex/badgeOnRedbricks.png
EA resources/wolftex/greybricks.png
SO resources/wolftex/door.png
WE resources/wolftex/figureOnWood.png

F 105,105,105
C 0,0,0

     
        1111111111111111111111111
        1000000000110000000000001
        1011000001110000000000001
        10010000000D0000000000001
111111111011000001110000000000001
10000000001100000111D111111111111
11110111111111011100000010001
11110111111111011101010010001
11000000110101011100000000001
10000000000000001100000010001
10000000000000001101010010001
11000001110101011111011110N0111
11110111 1110101 101111010001
11111111 1111111 111111111111
