NO ./resources/wolftex/greybricks.png
EA ./resources/wolftex/greybricksCracked.png
SO ./resources/wolftex/greybricks.png
WE ./resources/wolftex/figureOnGreyBricks.png
DO ./resources/wolftex/door.png

C 0,0,0
F ,

        1111111111111111111111111
        1000000000110000000000001
        1011000001110000000000001
        10010000000D000000000001
111111111011000001110000000000001
100000000011000001111D11111111111
11110111111111011100000010001
11110111111111011101010010001
11000000110101011100000010001
100000000000000011000000D0001
10000000000000001101010010001
11000001110101011111011110N0111
11110111 1110101 101111010001
11111111 1111111 111111111111



